
NO ./texture/north.bmp
SO ./texture/south.bmp

R 800                  600

WE ./texture/west.bmp
EA ./texture/east.bmp
S ./texture/south.bmp

F 46,46,46

C 8,0,0




        1111111111111111111111111
        1000000000110000000000001
        1011000001110000002000001
        10010000000000000W00000001
111111111011000001110000000000001
100000000011000001110111111111111
11110111111111011100000010001
11110111111111011101010010001
11000000110101011100000010001
10002000000000001100000010001
10000000000000001101010010001
110000011101010111110111100111
11110111 1110101 101111010001
11111111 1111111 11111111111
