
NO ./texture/north.bmp
SO ./texture/south.bmp

R 400                  320

WE ./texture/west.bmp
EA ./texture/east.bmp
S ./texture/sprite.bmp

F 46,46,46

C 8,0,0




        11111111111111111111111
        1011001110200000002W001
        1000000000001000001001
111111111011020001110000000001
100020000010000001110111111111111
101000000011200001110111111111111
11110111111111011100000010001
11110111111111011101010010001
11000000110101011100002010001
10200100001000001100100010001
10000100001000001101010010001
110000011101010111110111100111
11110111 1110101 101111010001
11111111 1111111 11111111111
